Mm, Mm, Mm, Mm, Mm, Mm, Mm, Mm, Mm, Mm, Mm, Mm, Mm, Mm, Mm, Mm, Mm, Mm, Mm, Mm, Mm, Mm, Mm, Mm, Mm, Mm, Mm, Mm, Mm, Mm, Mm, Mm, Mm, Mm, Mm, Mm, Mm, Mm, Mm, Mm, Mm, Mm, Hhd, Hhd, Hhd, Hhd, Hhd, Hhd, Hhd, Gg, Gg, Gg, Gg, Gg, Gg, Gg, Gg, Gg, Gg, Gg, Rrc, Mm
Mm, Mm, Mm, Mm, Mm, Mm, Mm, Mm, Mm, Mm, Mm, Mm, Mm, Mm, Mm, Mm, Mm, Mm, Mm, Mm, Mm, Mm, Mm, Mm, Mm, Mm, Mm, Mm, Mm, Mm, Mm, Mm, Mm, Mm, Mm, Mm, Mm, Mm, Mm, Mm, Mm, Mm, Hhd, Hhd, Hhd, Hhd, Hhd, Hhd, Hhd, Hhd, Hhd, Gg, Rp, Gg, Rp, Gg, Rp, Gg, Rrc, Rrc, Gg, Gg
Mm, Mm, Mm, Mm, Mm, Mm, Mm, Mm, Mm, Mm, Mm, Mm, Mm, Mm, Mm, Mm, Mm, Mm, Mm, Mm, Mm, Mm, Mm, Mm, Mm, Mm, Hhd, Mm, Mm, Mm, Gll^Fp, Mm, Gll^Fp, Mm, Mm, Mm, Mm, Mm, Mm, Mm, Mm, Mm, Hhd, Hhd, Rp, Hhd, Rp, Rp, Rp, Hhd, Rp, Rp, Gll^Fp, Rp, Gg, Rp, Gg, Rrc, Gg, Gg, Gg, Gg
Mm, Mm, Mm, Mm, Mm, Mm, Mm, Mm, Mm, Mm, Mm, Mm, Mm, Mm, Mm, Mm, Mm, Mm, Mm, Mm, Mm, Mm, Hhd, Mm, Hhd, Hhd, Hhd, Hhd, Hhd, Gll^Fp, Gll^Fp, Gll^Fp, Gll^Fp, Gll^Fp, Hhd, Hhd, Hhd, Mm, Mm, Mm, Hhd, Hhd, Rp, Rp, Hhd, Rp, Hhd, Hhd, Hhd, Rp, Hhd, Gll^Fp, Gll^Fp, Gll^Fp, Hhd, Gg, Rrc, Rrc, Gg, Gg, Gg, Gg
Mm, Mm, Mm, Mm, Mm, Mm, Chr, Chr, Chr, Mm, Mm, Mm, Hhd, Hhd, Hhd, Hhd, Hhd^Vhhr, Hhd, Hhd, Mm, Hhd, Hhd, Hhd, Hhd, Hhd, Hhd, Hhd, Gd^Vhr, Rp, Hhd, Rp, Hhd, Rp, Hhd, Rp, Hhd, Rp, Gd^Vhr, Rp, Hhd, Rp, Rp, Hhd, Hhd, Mm, Hhd, Hhd, Hhd, Hhd, Hhd, Hhd, Hhd, Hhd, Gll^Fp, Rrc, Rrc, Hhd, Rp, Gg, Gg, Gg, Gg
Mm, Mm, Mm, Mm, Mm, Mm, Chr, 4 Khr, Chr, Mm, Hhd, Hhd, Hhd, Gll^Fp, Gll^Fp, Gll^Fp, Rp, Rp, Rp, Rp, Rp, Hhd, Rp, Hhd, Rp, Rp, Rp, Rp, Gll^Fp, Rp, Gll^Fp, Rp, Gll^Fp, Rp, Hhd, Rp, Gll^Fp, Rp, Gll^Fp, Rp, Rp, Rp, Hhd, Hhd, Mm, Mm, Mm, Mm, Mm, Hhd, Hhd, Hhd, Hhd, Rrc, Gll^Fp, Gll^Fp, Gll^Fp, Rp, Gg, Gg, Gg, Gg
Mm, Mm, Mm, Mm, Mm, Mm, Mm, Chr, Hhd, Hhd, Hhd, Hhd, Rp, Gll^Fp, Rp, Rp, Gll^Fp, Hhd, Hhd, Hhd, Hhd, Rp, Hhd, Rp, Hhd, Hhd, Hhd, Hhd, Hhd, Hhd, Hhd, Gll^Fp, Hhd, Hhd, Hhd, Hhd, Hhd, Gll^Fp, Hhd, Gll^Fp, Hhd, Hhd, Hhd, Gd^Vhr, Mm, Mm, Mm, Mm, Mm, Mm, Hhd, Hhd, Rrc, Rrc, Hhd, Gll^Fp, Gll^Fp, Rp, Gg, Gg, Hhd, Gg
Mm, Mm, Mm, Mm, Mm, Mm, Mm, Mm, Hhd, Hhd, Rp, Rp, Rp, Rp, Hhd, Gll^Fp, Gll^Fp, Gll^Fp, Hhd, Hhd, Mm, Hhd, Hhd, Hhd, Rr^Vhc, Hhd, Hhd, Hhd, Mm, Mm, Mm, Hhd, Mm, Hhd, Hhd, Hhd, Hhd, Hhd, Hhd, Hhd, Hhd, Hhd, Mm, Mm, Mm, Mm, Mm, Mm, Mm, Gd^Vo, Hhd, Rrc, Hhd, Hhd, Hhd, Gll^Fp, Hhd, Rp, Gg, Hhd, Hhd, Hhd
Mm, Mm, Mm, Mm, Mm, Mm, Mm, Mm, Hhd, Hhd, Rp, Rp, Hhd, Hhd, Hhd, Hhd, Hhd, Hhd, Mm, Mm, Mm, Mm, Mm^Xm, Mm, Mm, Hhd, Mm, Mm, Mm, Mm, Mm, Mm^Xm, Mm^Xm, Mm^Xm, Mm^Xm, Mm^Xm, Mm^Xm, Hhd, Mm^Xm, Mm, Mm, Mm, Mm, Mm, Mm, Mm, Mm, Mm, Mm, Hhd, Hhd, Rrc, Hhd, Hhd, Mm, Hhd, Gll^Fp, Rp, Rp, Hhd, Hhd, Hhd
Mm, Mm, Mm, Mm, Mm, Mm, Hhd^Vhhr, Gll^Fp, Gll^Fp, Rp, Hhd, Hhd, Mm, Mm, Mm, Mm, Mm, Mm, Mm^Xm, Mm^Xm, Mm^Xm, Mm^Xm, Mm, Mm^Xm, Mm^Xm, Mm, Mm, Mm, Mm, Mm, Mm, Mm, Gll^Fp, Mm, Mm, Mm, Gll^Fp, Mm^Xm, Gll^Fp, Mm^Xm, Mm^Xm, Mm, Mm^Xm, Mm^Xm, Mm, Mm, Mm, Mm, Mm, Hhd, Rrc, Rrc, Hhd, Gd^Vo, Mm, Mm, Hhd, Gll^Fp, Rp, Hhd, Hhd, Hhd
Mm, Mm, Mm, Mm, Mm, Mm, Gll^Fp, Gll^Fp, Hhd, Rp, Hhd, Hhd, Hhd^Vhhr, Mm, Mm, Mm, Mm^Xm, Mm^Xm, Mm, Mm, Cf, Mm, Mm, Mm, Mm, Mm^Xm, Mm^Xm, Mm, Mm^Xm, Mm, Gll^Fp, Gll^Fp, Hhd, Mm, Hhd, Hhd, Gll^Fp, Hhd, Gll^Fp, Gll^Fp, Gll^Fp, Mm^Xm, Gd^Vo, Mm, Mm, Mm, Mm, Mm, Hhd, Hhd, Rrc, Hhd, Mm, Mm, Mm, Mm, Hhd, Hhd, Rp, Hhd, Gd^Vhr, Gll^Fp
Mm, Mm, Mm, Mm, Mm, Mm, Gll^Fp, Gll^Fp, Hhd, Rp, Rp, Hhd, Gll^Fp, Mm, Mm, Mm^Xm, Mm, Mm, Mm, Cf, 6 Kf, Cf, Cf, Cf, Cf, Mm^Xm, Mm, Mm^Xm, Mm, Hhd, Hhd, Gll^Fp, Hhd, Hhd, Rrc, Hhd, Rrc, Rrc, Rrc, Gll^Fp, Hhd, Hhd, Hhd, Mm, Mm, Mm, Mm, Hhd, Hhd, Hhd, Rrc, Hhd, Mm, Mm^Xm, Mm, Hhd, Hhd, Hhd, Rp, Hhd, Gll^Fp, Gll^Fp
Mm, Mm, Mm, Mm, Mm, Mm, Mm, Gll^Fp, Hhd, Hhd, Rp, Gll^Fp, Gll^Fp, Mm, Mm, Mm^Xm, Mm, Mm, Cf, Cf, Cf, Cf, Cf, Cf, Cf, Mm, Mm, Mm^Xm, Mm, Re, Re, Hhd, Rrc, Rrc, Hhd, Rrc, Hhd, Hhd, Hhd, Rrc, Rrc, Hhd, Hhd, Gll^Fp, Hhd, Mm, Mm, Hhd, Hhd, Rrc, Hhd, Hhd, Mm, Mm^Xm, Mm, Hhd, Gll^Fp, Hhd, Rp, Hhd, Gll^Fp, Gll^Fp
Mm, Mm, Mm, Mm, Mm, Mm, Mm, Hhd, Hhd, Hhd, Rp, Gll^Fp, Gll^Fp, Mm, Mm^Xm, Mm^Xm, Mm, Cf, Cf, Cf, Mm, Mm, Mm, Cf, Mm, Mm, Mm, Mm, Kf, Cf, Re, Rrc, Cf, Hhd, Mm, Hhd, Hhd, Hhd, Gll^Fp, Hhd, Hhd, Rrc, Rrc, Hhd, Hhd, Hhd, Hhd, Hhd, Rrc, Rrc, Hhd, Gd^Vo, Mm^Xm, Mm^Xm, Hhd, Gll^Fp, Gd^Vhr, Rp, Hhd, Hhd, Gll^Fp, Gll^Fp
Mm, Mm, Mm, Mm, Mm, Gd^Vo, Mm, Mm, Hhd, Hhd, Rp, Gll^Fp, Hhd, Mm, Mm^Xm, Mm, Mm, Cf, Cf, Cf, Mm, Mm, Mm, Mm, Mm, Mm, Uu^Vud, Mm^Xm, Mm, Cf, Re, Rrc, Cf, Kf, Mm, Mm, Uu^Vud, Mm, Mm, Gll^Fp, Gll^Fp, Hhd, Hhd, Rrc, Rrc, Hhd, Hhd, Hhd, Rrc, Hhd, Mm, Mm, Mm^Xm, Mm, Gll^Fp, Gll^Fp, Rp, Rp, Gll^Fp, Hhd, Mm, Mm
Mm, Mm, Mm, Mm, Mm, Mm, Mm, Mm, Hhd, Hhd, Rp, Hhd, Hhd, Mm, Mm^Xm, Mm, Mm, Mm, Mm, Mm, Mm, Mm, Mm, Mm, Mm, Mm, Mm, Mm, Hhd, Re, Hhd, Rrc, Hhd, Mm, Mm^Xm, Mm, Mm^Xm, Mm, Mm, Mm, Gll^Fp, Gll^Fp, Gll^Fp, Hhd, Hhd, Rrc, Rrc, Rrc, Hhd, Hhd, Mm, Mm, Mm^Xm, Mm, Hhd, Hhd, Rp, Hhd, Hhd, Gll^Fp, Mm, Mm
Mm, Mm, Mm, Mm, Mm, Mm, Hhd, Hhd, Hhd, Rp, Hhd, Hhd, Hhd, Mm, Mm^Xm, Mm, Uu^Vud, Mm, Mm, Mm, Mm, Mm, Mm, Mm, Mm, Mm, Mm, Mm^Xm, Mm^Xm, Hhd, Hhd, Rrc, Rrc, Hhd, Gll^Fp, Mm^Xm, Mm, Mm^Xm, Mm^Xm, Mm, Mm, Mm, Mm, Hhd, Mm, Gd^Vo, Hhd, Hhd, Hhd, Hhd, Mm^Xm, Mm^Xm, Mm, Mm, Hhd, Hhd, Rp, Gll^Fp, Gll^Fp, Gll^Fp, Mm, Mm
Mm, Mm, Mm, Mm, Mm, Mm, Gll^Fp, Gll^Fp, Rp, Rp, Gll^Fp, Gll^Fp, Gll^Fp, Mm, Mm^Xm, Mm, Mm, Mm, Mm, Mm, Mm, Mm, Mm, Mm, Mm, Mm, Mm, Mm, Mm^Xm, Mm, Gll^Fp, Gll^Fp, Rrc, Gll^Fp, Gll^Fp, Mm, Mm, Mm, Mm, Mm^Xm, Mm^Xm, Mm, Mm, Mm, Mm, Mm, Mm, Hhd, Mm^Xm, Mm^Xm, Mm, Mm, Mm, Hhd, Hhd, Rp, Gll^Fp, Gll^Fp, Mm, Mm, Mm, Mm
Mm, Mm, Mm, Mm, Mm, Mm, Gll^Fp, Hhd, Rp, Hhd, Hhd, Gll^Fp, Mm, Mm, Mm^Xm, Mm^Xm, Mm^Xm, Md, Mm, Kf, Cf, Mm, Mm, Mm, Mm, Mm, Mm, Mm, Mm^Xm, Mm, Gll^Fp, Gll^Fp, Rrc, Gll^Fp, Gll^Fp, Mm, Mm, Mm, Uu^Vud, Mm, Mm, Mm^Xm, Mm, Mm, Mm, Mm, Mm, Mm, Mm^Xm, Mm, Mm, Mm, Hhd, Hhd, Rp, Rp, Hhd, Hhd, Mm, Mm, Mm, Mm
Mm, Mm, Mm, Mm, Mm, Gll^Fp, Gll^Fp, Gll^Fp, Rp, Hhd, Gs^Vh, Mm, Mm, Mm, Mm, Mm, Gll^Fp, Mm^Xm, Re, Cf, Re, Re, Re, Mm, Hhd, Gll^Fp, Hhd, Mm, Mm, Mm^Xm, Mm, Gll^Fp, Hhd, Rrc, Rrc, Gll^Fp, Hhd, Mm, Mm, Mm, Mm^Xm, Mm^Xm, Mm^Xm, Mm^Xm, Mm^Xm, Mm, Mm^Xm, Mm, Mm^Xm, Mm, Mm, Hhd, Hhd, Hhd, Rp, Hhd, Hhd, Hhd, Mm, Mm, Mm, Mm
Mm, Mm, Mm, Mm, Mm, Mm, Mm, Hhd, Rp, Hhd, Mm, Mm, Mm^Xm, Mm^Xm, Mm, Mm, Hhd, Hhd, Re, Re, Rrc, Rrc, Rrc, Hhd, Rrc, Hhd, Hhd, Uu^Vud, Mm^Xm, Mm^Xm, Mm^Xm, Hhd, Hhd, Hhd, Hhd, Rrc, Hhd, Gll^Fp, Gll^Fp, Mm, Mm, Mm, Mm, Mm, Mm, Mm^Xm, Mm, Mm^Xm, Mm, Mm, Mm, Hhd, Hhd, Rp, Hhd, Hhd, Hhd, Gd^Vhr, Mm, Mm, Mm, Mm
Mm, Mm, Mm, Mm, Mm, Mm, Gs^Vh, Hhd, Rp, Hhd, Gll^Fp, Mm^Xm, Mm, Mm, Hhd, Hhd, Hhd, Hhd, Rrc, Rrc, Cf, Cf, Hhd, Rrc, Hhd, Rrc, Hhd, Gll^Fp, Gll^Fp, Mm^Xm, Mm^Xm, Hhd, Hhd, Hhd, Uu^Vud, Rrc, Rrc, Gll^Fp, Hhd, Mm, Mm, Mm, Mm, Mm, Mm, Mm, Mm, Mm, Gd^Vo, Mm, Mm, Hhd, Gll^Fp, Rp, Hhd, Hhd, Mm, Mm, Mm, Mm, Mm, Mm
Mm, Mm, Mm, Mm, Mm, Mm, Hhd, Hhd, Rp, Gll^Fp, Hhd, Mm, Mm, Gll^Fp, Gll^Fp, Gll^Fp, Rrc, Rrc, Hhd, Re, Mm, Kf, Mm, Hhd, Hhd, Rrc, Rrc, Hhd, Gll^Fp, Gll^Fp, Mm, Mm, Mm, Gll^Fp, Gll^Fp, Gll^Fp, Rrc, Hhd, Hhd, Hhd, Mm, Mm, Mm, Mm, Mm, Mm, Mm, Mm, Mm, Mm, Mm, Hhd, Gll^Fp, Rp, Gll^Fp, Gll^Fp, Hhd, Mm, Mm, Mm, Mm, Mm
Mm, Mm, Mm, Mm, Mm, Mm, Gll^Fp, Hhd, Rp, Hhd, Hhd, Mm, Mm, Gll^Fp, Gll^Fp, Hhd, Rrc, Hhd, Hhd, Mm, Mm, Mm, Mm, Mm, Mm, Hhd, Hhd, Rrc, Hhd, Hhd, Mm, Mm, Mm, Mm, Mm, Hhd, Hhd, Rrc, Hhd, Hhd, Hhd, Mm, Mm, Mm, Mm, Mm, Mm, Mm, Mm, Mm, Mm, Gll^Fp, Gll^Fp, Rp, Rp, Gll^Fp, Gll^Fp, Mm, Mm, Mm, Mm, Mm
Mm, Mm, Mm, Mm, Mm, Mm, Gll^Fp, Hhd, Rp, Hhd, Hhd, Mm, Mm, Hhd, Gll^Fp, Hhd, Rrc, Hhd, Hhd, Hhd, Mm, Mm^Xm, Mm, Mm, Mm, Hhd, Hhd, Rrc, Hhd, Hhd, Mm, Mm, Mm, Mm, Mm, Hhd, Hhd, Rrc, Hhd, Hhd, Gll^Fp, Hhd, Mm, Mm, Mm, Mm, Mm, Mm, Mm, Mm, Mm, Gll^Fp, Gll^Fp, Hhd, Hhd, Rp, Gll^Fp, Gll^Fp, Hhd, Mm, Mm, Mm
Mm, Mm, Mm, Mm, Mm, Mm, Gll^Fp, Gll^Fp, Rp, Hhd, Hhd, Mm, Mm, Mm, Mm, Hhd, Hhd, Rrc, Hhd, Hhd, Mm, Mm^Xm, Mm^Xm, Mm, Mm, Mm, Hhd, Rrc, Rrc, Gll^Fp, Gll^Fp, Mm, Gll^Fp, Mm, Gll^Fp, Hhd, Rrc, Rrc, Hhd, Gll^Fp, Gll^Fp, Hhd, Mm, Mm, Mm, Mm, Mm, Mm, Mm, Gd^Vo, Mm, Mm, Hhd, Hhd, Hhd, Rp, Hhd, Hhd, Hhd, Mm, Mm, Mm
Mm, Mm, Mm, Mm, Mm, Mm, Mm, Gll^Fp, Rp, Hhd, Hhd, Mm, Mm, Mm, Mm, Hhd, Hhd, Rrc, Rrc, Hhd, Mm, Mm, Mm, Mm^Xm, Mm, Mm, Uu^Vud, Hhd, Hhd, Rrc, Rrc, Gll^Fp, Gll^Fp, Hhd, Hhd, Hhd, Rrc, Hhd, Gll^Fp, Gll^Fp, Gll^Fp, Hhd, Mm, Mm, Mm, Mm, Mm, Mm, Mm, Mm, Mm, Mm, Mm, Hhd, Hhd, Rp, Hhd, Hhd, Hhd, Mm, Mm, Mm
Mm, Mm, Mm, Mm, Mm, Mm, Hhd, Hhd, Rp, Gll^Fp, Gll^Fp, Hhd, Mm, Mm, Mm, Mm, Mm, Hhd, Rrc, Hhd, Hhd, Mm, Mm, Mm^Xm, Mm^Xm, Mm, Hhd, Hhd, Gll^Fp, Hhd, Hhd, Rrc, Rrc, Hhd, Rrc, Rrc, Hhd, Hhd, Mm, Hhd, Mm, Mm, Mm, Mm, Mm, Mm, Mm, Mm, Mm, Mm, Mm, Mm, Mm, Hhd, Hhd, Rp, Gll^Fp, Gll^Fp, Gll^Fp, Mm, Mm, Mm
Mm, Mm, Hhd, Mm, Mm, Mm, Hhd, Hhd, Rp, Hhd, Gll^Fp, Gll^Fp, Mm, Mm, Mm, Gs^Vh, Hhd, Hhd, Rrc, Gs^Vh, Gll^Fp, Hhd, Mm, Mm, Mm, Mm^Xm, Mm, Hhd, Gll^Fp, Gll^Fp, Gll^Fp, Hhd, Hhd, Rrc, Gll^Fp, Gll^Fp, Gll^Fp, Uu^Vud, Mm, Mm, Mm, Mm, Mm, Mm, Mm, Mm, Mm, Mm, Mm, Mm, Mm, Mm, Mm, Mm, Gll^Fp, Rp, Hhd, Gll^Fp, Mm, Mm, Mm, Mm
Hhd, Hhd, Hhd, Hhd, Hhd, Mm, Hhd, Rp, Hhd, Gll^Fp, Gll^Fp, Gll^Fp, Mm, Mm, Gll^Fp, Gll^Fp, Hhd^Fp, Rrc, Hhd, Hhd, Gll^Fp, Gll^Fp, Mm, Mm, Mm, Mm^Xm, Mm^Xm, Mm, Mm, Mm, Mm, Gll^Fp, Gll^Fp, Hhd, Mm, Hhd, Mm, Mm, Mm, Mm, Mm, Mm, Mm, Mm, Mm, Mm, Mm, Mm, Mm, Mm, Mm, Hhd^Vhhr, Gll^Fp, Gll^Fp, Gll^Fp, Rp, Hhd, Gll^Fp, Mm, Mm, Mm, Mm
Hhd, Hhd, Hhd, Gll^Fp, Gll^Fp, Gs^Vh, Rp, Rp, Hhd, Gll^Fp, Mm, Mm, Gll^Fp, Gll^Fp, Hhd^Fp, Gll^Fp, Rrc, Rrc, Hhd^Fp, Gll^Fp, Hhd, Gll^Fp, Mm, Mm, Mm, Mm, Mm, Mm^Xm, Mm^Xm, Mm^Xm, Mm^Xm, Mm, Mm, Mm, Mm, Mm, Mm^Xm, Mm, Mm^Xm, Mm^Xm, Mm, Mm, Mm, Mm, Mm, Mm, Mm, Mm, Mm, Mm, Hhd, Hhd, Hhd, Hhd, Rp, Rp, Hhd, Gll^Fp, Mm, Mm, Mm, Mm
Hhd, Hhd, Gll^Fp, Gll^Fp, Gll^Fp, Gll^Fp, Rp, Rp, Gll^Fp, Hhd, Hhd, Mm, Hhd^Fp, Hhd^Fp, Hhd^Fp, Hhd^Fp, Rrc, Hhd^Fp, Hhd^Fp, Hhd, Mm, Mm, Mm, Mm, Mm, Mm, Mm, Mm, Mm, Mm, Mm, Mm^Xm, Mm^Xm, Mm^Xm, Mm^Xm, Mm^Xm, Mm, Mm^Xm, Mm, Mm, Mm, Mm, Mm, Mm, Mm, Mm, Mm, Mm, Hhd, Hhd, Hhd, Hhd, Rp, Rp, Hhd, Hhd, Hhd, Hhd, Mm, Mm, Mm, Mm
Gg, Hhd, Hhd, Gll^Fp, Gll^Fp, Gll^Fp, Rp, Hhd, Gll^Fp, Gll^Fp, Gll^Fp, Hhd, Hhd^Fp, Hhd^Fp, Rrc, Rrc, Hhd^Fp, Hhd^Fp, Mm, Mm, Mm, Mm, Mm, Mm, Mm, Mm, Mm, Mm, Mm, Mm, Mm, Mm, Mm, Mm, Mm, Mm, Mm, Mm, Mm, Mm, Mm, Mm, Mm, Mm, Mm, Mm, Hhd, Gll^Fp, Hhd^Vhhr, Hhd, Rp, Rp, Hhd, Hhd, Hhd, Hhd, Mm, Mm, Mm, Mm, Mm, Mm
Gg, Gg, Ce, Gll^Fp, Rp, Rp, Gll^Fp, Hhd, Gll^Fp, Gll^Fp, Gll^Fp, Hhd, Rrc, Rrc, Hhd, Hhd^Fp, Hhd^Fp, Mm^Fp, Mm, Mm, Mm, Mm, Mm, Mm, Mm, Mm, Mm, Mm, Hhd, Mm, Hhd, Mm, Hhd, Mm, Hhd, Mm, Gg^Ve, Mm, Gll^Fp, Mm, Mm, Mm, Mm, Mm, Mm, Mm, Gll^Fp, Gll^Fp, Gll^Fp, Gll^Fp, Rp, Hhd, Gll^Fp, Hhd, Mm, Mm, Mm, Mm, Mm, Mm, Mm, Mm
Gg, Ce, 1 Ke, Ce, Rp, Hhd, Hhd, Gll^Fp, Gs^Vh, Hhd, Rrc, Rrc, Hhd, Hhd, Hhd, Hhd^Fp, Mm, Mm, Mm, Mm, Hhd, Mm, Hhd, Mm, Hhd, Mm, Hhd, Gs^Vh, Hhd, Hhd, Hhd, Hhd, Hhd, Hhd, Hhd, Hhd, Hhd, Gll^Fp, Gll^Fp, Gll^Fp, Hhd, Mm, Hhd, Hhd, Hhd, Hhd, Hhd, Gll^Fp, Rp, Rp, Gll^Fp, Hhd, Gll^Fp, Mm, Mm, Mm, Mm, Mm, Mm, Mm, Mm, Mm
Gg, Ce, Ce, Ce, Rp, Gg, Gg, Hhd, Rrc, Rrc, Hhd, Gll^Fp, Gll^Fp, Gll^Fp, Gll^Fp, Mm, Mm, Mm, Hhd, Hhd, Gll^Fp, Gll^Fp, Hhd, Hhd, Hhd, Hhd, Hhd, Hhd, Rp, Rp, Rp, Hhd, Rp, Hhd, Rp, Hhd, Rp, Gll^Fp, Rp, Gll^Fp, Gll^Fp, Hhd, Hhd, Hhd, Rp, Hhd, Rp, Rp, Gll^Fp, Gll^Fp, Gll^Fp, Gll^Fp, Mm, Mm, Mm, Hhd^Vhhr, Mm, Mm, Mm, Mm, Mm, Mm
Gg, Gg, Gg, Gg, Rp, Gg, Rrc, Rrc, Rp, Hhd, Hhd, Gll^Fp, Gll^Fp, Gll^Fp, Gll^Fp, Hhd, Hhd, Hhd, Gll^Fp, Gll^Fp, Gll^Fp, Gll^Fp, Rp, Rp, Rp, Rp, Rp, Rp, Hhd, Hhd, Hhd, Rp, Hhd, Rp, Hhd, Rp, Hhd, Rp, Hhd, Rp, Rp, Rp, Rp, Rp, Rp, Rp, Hhd, Gll^Fp, Hhd, Gll^Fp, Hhd, Mm, Chr, Mm, Mm, Mm, Mm, Mm, Mm, Mm, Mm, Mm
Gg, Gg, Gg, Gg, Rrc, Rrc, Gg, Gg, Gg, Rp, Rp, Hhd, Hhd, Gll^Fp, Gll^Fp, Hhd, Hhd, Hhd, Rp, Hhd, Rp, Rp, Gll^Fp, Hhd, Gll^Fp, Gll^Fp, Gll^Fp, Hhd, Hhd, Hhd, Hhd, Gll^Fp, Gll^Fp, Gll^Fp, Gll^Fp, Hhd, Hhd, Hhd, Hhd, Hhd, Gll^Fp, Hhd, Gll^Fp, Hhd, Hhd, Hhd, Hhd, Hhd, Hhd, Hhd, Mm, Chr, 5 Khr, Chr, Mm, Mm, Mm, Mm, Mm, Mm, Mm, Mm
Gg, Gg, Gg, Rrc, Ce, Ce, Ce, Gg, Gg, Gg, Ce, Rp, Rp, Rp, Rp, Gs^Vh, Rp, Rp, Hhd, Rp, Hhd, Hhd, Hhd, Gll^Fp, Hhd, Gll^Fp, Mm, Mm, Mm, Gs^Vh, Mm, Hhd, Gll^Fp, Gll^Fp, Gll^Fp, Gll^Fp, Mm, Hhd, Gll^Fp, Gll^Fp, Gll^Fp, Gll^Fp, Gll^Fp, Gll^Fp, Hhd, Hhd, Hhd, Hhd, Mm, Mm, Mm, Chr, Chr, Chr, Mm, Mm, Mm, Mm, Mm, Mm, Mm, Mm
Gg, Gg, Rrc, Rrc, Ce, 3 Ke, Ce, Gg, Gg, Ce, 2 Ke, Ce, Gg, Hhd, Hhd, Rp, Hhd, Hhd, Hhd, Hhd, Mm, Hhd, Mm, Hhd, Mm, Mm, Mm, Mm, Mm, Mm, Mm, Mm, Mm, Mm, Mm, Mm, Mm, Mm, Mm, Mm, Mm, Gg^Ve, Mm, Mm, Mm, Mm, Mm, Mm, Mm, Mm, Mm, Mm, Mm, Mm, Mm, Mm, Mm, Mm, Mm, Mm, Mm, Mm
Rrc, Rrc, Rrc, Gg, Gg, Ce, Gg, Gg, Gg, Ce, Ce, Ce, Gg, Gll^Fp, Gll^Fp, Gll^Fp, Gll^Fp, Gll^Fp, Hhd, Hhd, Mm, Mm, Mm, Mm, Mm, Mm, Mm, Mm, Mm, Mm, Mm, Mm, Mm, Mm, Mm, Mm, Mm, Mm, Mm, Mm, Mm, Mm, Mm, Mm, Mm, Mm, Mm, Mm, Mm, Mm, Mm, Mm, Mm, Mm, Mm, Mm, Mm, Mm, Mm, Mm, Mm, Mm
Gg, Rrc, Gg, Gg, Gg, Gg, Gg, Gg, Gg, Gg, Gg, Gg, Gg, Gg, Gg, Gll^Fp, Hhd, Gll^Fp, Hhd, Hhd, Mm, Mm, Mm, Mm, Mm, Mm, Mm, Mm, Mm, Mm, Mm, Mm, Mm, Mm, Mm, Mm, Mm, Mm, Mm, Mm, Mm, Mm, Mm, Mm, Mm, Mm, Mm, Mm, Mm, Mm, Mm, Mm, Mm, Mm, Mm, Mm, Mm, Mm, Mm, Mm, Mm, Mm
