Xv, Xv, Xv, Xv, Xv, Xv, Xv, Xv, Xv, Xv, Xv, Xv, Xv, Xv, Xv, Xv, Xv, Xv, Xv, Xv, Xv, Xv, Xv, Xv, Xv, Xv, Xv, Xv, Xv, Xv, Xv, Xv, Xv, Xv, Xv, Xv, Xv
Xv, Xv, Xv, Xv, Xv, Xv, Xv, Xv, Xv, Xv, Xv, Xv, Xv, Xv, Xv, Xv, Xv, Xv, Rra, Xv, Xv, Xv, Xv, Xv, Xv, Xv, Xv, Xv, Xv, Xv, Xv, Xv, Xv, Xv, Xv, Xv, Xv
Xv, Xv, Xv, Xv, Xv, Xv, Xv, Xv, Xv, Xv, Xv, Xv, Xv, Xv, Xv, Xv, Ch, 1 Kh, Rrc, 4 Kh, Ch, Xv, Xv, Xv, Xv, Xv, Xv, Xv, Xv, Xv, Xv, Xv, Xv, Xv, Xv, Xv, Xv
Xv, Xv, Xv, Xv, Xv, Xv, Xv, Xv, Xv, Xv, Xv, Xv, Xv, Xv, Gg, Ch, Ch, Ch, 5 Kh, Ch, Ch, Ch, Gg, Xv, Xv, Xv, Xv, Xv, Xv, Xv, Xv, Xv, Xv, Xv, Xv, Xv, Xv
Xv, Xv, Xv, Xv, Xv, Xv, Xv, Xv, Xv, Xv, Xv, Xv, Gll^Fdf, Gs^Vh, Rp, Ch, Ch, Ch, Rrc, Ch, Ch, Ch, Rp, Gs^Vh, Gll^Fdf, Xv, Xv, Xv, Xv, Xv, Xv, Xv, Xv, Xv, Xv, Xv, Xv
Xv, Xv, Xv, Xv, Xv, Xv, Xv, Xv, Xv, Xv, Hh, Hh, Rp, Rp, Rp, Rp, Rp, Rrc, Rrc, Rrc, Rp, Rp, Rp, Rp, Rp, Hh, Hh, Xv, Xv, Xv, Xv, Xv, Xv, Xv, Xv, Xv, Xv
Xv, Xv, Xv, Xv, Xv, Xv, Xv, Xv, Gll^Fdf, Hh, Rp, Rp, Rp, Rp, Rp, Rp, Ss, Rrc, Rrc, Rrc, Ss, Rp, Rp, Rp, Rp, Rp, Rp, Hh, Gll^Fdf, Xv, Xv, Xv, Xv, Xv, Xv, Xv, Xv
Xv, Xv, Xv, Xv, Xv, Xv, Gg, Gll^Fdf, Rp, Rp, Rp, Gll^Fdf, Rp, Rp, Hh, Ss^Bw\, Rp, Rrc, Gg^Fet, Rrc, Rp, Ss^Bw/, Hh, Rp, Rp, Gll^Fdf, Rp, Rp, Rp, Gll^Fdf, Gg, Xv, Xv, Xv, Xv, Xv, Xv
Xv, Xv, Xv, Xv, Gg, Gll^Fdf, Rp, Rp, Rp, Rp, Rp, Rp, Gll^Fmf, Rp, Ss^Bw\, Ss, Mm^Xm, Rrc, Rrc, Rrc, Mm^Xm, Ss, Ss^Bw/, Rp, Gll^Fmf, Rp, Rp, Rp, Rp, Rp, Rp, Gll^Fdf, Gg, Xv, Xv, Xv, Xv
Xv, Xv, Gs^Vh, Gll^Fdf, Rp, Rp, Rp, Rp, Rp, Rp, Gll^Vc, Gll^Fmf, Ss, Ss, Ss, Rp, Rp^Vhc, Rrc, Rrc, Rrc, Rp^Vhc, Rp, Ss, Ss, Ss, Gll^Fmf, Gs^Vc, Rp, Rp, Rp, Rp, Rp, Rp, Gll^Fdf, Gs^Vh, Xv, Xv
Gg, Gg, Rp, Rp, Gll^Fdf, Rp, Rp, Rp, Rp, Gll^Fmf, Gg, Gll^Fmf, Ss, Ss, Ss, Mm, Mm, Rrc, Rrc, Rrc, Mm, Mm, Ss, Ss, Ss, Gll^Fmf, Gg, Gll^Fmf, Rp, Rp, Rp, Rp, Gll^Fdf, Rp, Rp, Gg, Gg
Gg, Hh, Rp, Rp, Rp, Rp, Mm, Hh, Gg, Rp, Rp, Ss, Ss^Vhs, Ss, Gg, Hh, Mm, Rrc, Rrc, Rrc, Mm, Hh, Gg, Ss, Ss^Vhs, Ss, Rp, Rp, Gg, Hh, Mm, Rp, Rp, Rp, Rp, Hh, Gg
Gg, Hh, Rp, Rp, Rp, Mm, Hh^Vo, Hh, Gll^Fmf, Gg, Ss, Ss^Bw\, Ss^Bw\, Ss, Gg, Hh, Hh^Vhc, Rrc, Gg^Fet, Rrc, Hh^Vhc, Hh, Gg, Ss, Ss^Bw/, Ss^Bw/, Ss, Gg, Gll^Fmf, Hh, Hh^Vo, Mm, Rp, Rp, Rp, Hh, Gg
Gg, Hh, Rp, Rp, Rp, Mm, Hh, Gg, Gll^Fmf, Gll^Fmf, Ss, Ss, Gg, Rp, Rp, Hh, Mm, Rrc, Rrc, Rrc, Mm, Hh, Rp, Rp, Gg, Ss, Ss, Gll^Fmf, Gll^Fmf, Gg, Hh, Mm, Rp, Rp, Rp, Hh, Gg
Gg, Gll^Fmf, Rp, Gll^Fdf, Rp, Hh, Hh^Fmf, Gg, Mm, Ss, Ss, Gll^Fmf, Mm, Gll^Fmf, Gll^Fmf, Rp, Rp, Rrc, Rrc, Rrc, Rp, Rp, Gll^Fmf, Gll^Fmf, Mm, Gll^Fmf, Ss, Ss, Mm, Gg, Hh^Fmf, Hh, Rp, Gll^Fdf, Rp, Gll^Fmf, Gg
Gg, Gll^Fmf, Rp, Rp, Rp, Gll^Fmf, Gll^Fmf, Gll^Fmf, Mm, Ss, Ss, Ss, Mm, Gll^Fmf, Ds, Gg, Rp, Rrc, Rrc, Rrc, Rp, Gg, Ds, Gll^Fmf, Mm, Ss, Ss, Ss, Mm, Gg^Fmf, Gg^Fmf, Gg^Fmf, Rp, Rp, Rp, Gll^Fmf, Gg
Ds, Ds, Cer, Rp, Cer, Ds, Dd^Vda, Ds, Ss, Ss, Gg^Fet, Ss, Ss, Ds, Ds, Khr^Vov, Chw, Rrc, Rrc, Rrc, Chw, Khr^Vov, Ds, Ds, Ss, Ss, Gg^Fet, Ss, Ss, Ds, Dd^Vda, Ds, Cer, Rp, Cer, Ds, Ds
Wo, Ww, Ww, Ww^Bsb|, Ww, Ww, Ww, Ww, Ww, Ss, Ss^Vhs, Ss, Ww, Ww, Ww, Chw, Chw, Wwf, Wwf, Wwf, Chw, Chw, Ww, Ww, Ww, Ss, Ss^Vhs, Ss, Ww, Ww, Ww, Ww, Ww, Ww^Bsb|, Ww, Ww, Ww
Wo, Wo, Wwr, Wo^Bsb|, Wwr, Wo, Wo, Wo, Wwr, Wo, Ss, Wo, Wwr, Wo, Wo, Ww, Ww, Wwf, Wwf, Wwf, Ww, Ww, Wo, Wo, Wwr, Wo, Ss, Wo, Wwr, Wo, Wo, Wo, Wwr, Wo^Bsb|, Wwr, Wo, Wo
Wo, Ww^Vm, Wwr, Wo^Bsb|, Wwr, Ww^Vm, Wo, Wo, Wwr, Wwr, Ss, Wwr, Wwr, Wo, Wo, Ww^Vm, Ww, Wwf, Wwf, Wwf, Ww, Ww^Vm, Wo, Wo, Wwr, Wwr, Ss, Wwr, Wwr, Wo, Wo, Ww^Vm, Wwr, Wo^Bsb|, Wwr, Ww^Vm, Wo
Ww, Wo, Ww, Wo^Bsb|, Ww, Wo, Ww, Wo, Ww, Wo, Ss^Vhs, Wo, Ww, Wo, Ww, Ww, Chw, Wwf, Wwf, Wwf, Chw, Ww, Ww, Wo, Ww, Wo, Ss^Vhs, Wo, Ww, Wo, Ww, Wo, Ww, Wo^Bsb|, Ww, Wog, Ww
Ds, Ww, Cer, Rp^Bsb|, Cer, Ww, Dd^Vda, Ww, Ss, Ss, Gg^Fet, Ss, Ss, Ww, Ds, Chw, Chw, Wwf, Rrc, Wwf, Chw, Chw, Ds, Ww, Ss, Ss, Gg^Fet, Ss, Ss, Ww, Dd^Vda, Ww, Cer, Ww^Bsb|, Cer, Ww, Ds
Gg, Ds, Rp, Rp, Rp, Ds, Gll^Fmf, Ds, Mm, Ss, Ss, Ss, Mm, Ds, Ds, Khr^Vov, Rp, Rrc, Rrc, Rrc, Rp, Khr^Vov, Ds, Ds, Mm, Ss, Ss, Ss, Mm, Ds, Gg^Fmf, Ds, Rp, Rp, Rp, Ds, Gg
Gg, Gll^Fmf, Rp, Rp, Rp, Gll^Fmf, Hh^Fmf, Gll^Fmf, Mm, Ss, Ss, Ss, Mm, Gll^Fmf, Gll^Fmf, Gg, Rp, Rrc, Rrc, Rrc, Rp, Gg, Gg^Fmf, Gg^Fmf, Mm, Ss, Ss, Ss, Mm, Gg^Fmf, Hh^Fmf, Gg^Fmf, Rp, Rp, Rp, Gll^Fmf, Gg
Gg, Gll^Fmf, Rp, Gll^Fdf, Rp, Hh, Hh, Gg, Gll^Fmf, Ss, Ss, Gll^Fmf, Gg, Gll^Fmf, Rp, Rp, Mm, Rrc, Rrc, Rrc, Mm, Rp, Rp, Gg^Fmf, Gg, Gll^Fmf, Ss, Ss, Gll^Fmf, Gg, Hh, Hh, Rp, Gll^Fdf, Rp, Gll^Fmf, Gg
Gg, Hh, Rp, Rp, Rp, Mm, Hh^Vo, Gg, Gll^Fmf, Gll^Fmf, Ss, Ss, Ss^Bw/, Rp, Gg^Fmf, Hh^Fmf, Hh^Vhc, Rrc, Gg^Fet, Rrc, Hh^Vhc, Hh^Fmf, Gg^Fmf, Rp, Ss^Bw\, Ss, Ss, Gll^Fmf, Gll^Fmf, Gg, Hh^Vo, Mm, Rp, Rp, Rp, Hh, Gg
Gg, Hh, Rp, Rp, Rp, Mm, Mm, Hh, Hh, Gg, Rp, Ss^Bw/, Ss^Vhs, Ss, Gg, Hh, Mm, Rrc, Rrc, Rrc, Mm, Hh, Gg, Ss, Ss^Vhs, Ss^Bw\, Rp, Gg, Hh, Hh, Mm, Mm, Rp, Rp, Rp, Hh, Gg
Gg, Hh, Rp, Rp, Gll^Fdf, Rp, Rp, Hh, Rp, Rp, Gg, Ss, Ss, Ss, Ss, Hh, Mm, Rrc, Rrc, Rrc, Mm, Hh, Ss, Ss, Ss, Ss, Gg, Rp, Rp, Hh, Rp, Rp, Gll^Fdf, Rp, Rp, Hh, Gg
Xv, Gg, Gs^Vh, Rp, Rp, Rp, Rp, Rp, Rp, Gll^Fmf, Gs^Vc, Gll^Fmf, Ss, Ss, Ss, Mm, Rp^Vhc, Rrc, Rrc, Rrc, Rp^Vhc, Mm, Ss, Ss, Ss, Gll^Fmf, Gs^Vc, Gll^Fmf, Rp, Rp, Rp, Rp, Rp, Rp, Gs^Vh, Gg, Xv
Xv, Xv, Xv, Gll^Fdf, Gg, Rp, Rp, Rp, Rp, Rp, Rp, Gll^Fmf, Gll^Fmf, Ss, Ss^Bw/, Rp, Mm^Xm, Rrc, Rrc, Rrc, Mm^Xm, Rp, Ss^Bw\, Ss, Gll^Fmf, Gll^Fmf, Rp, Rp, Rp, Rp, Rp, Rp, Gg, Gll^Fdf, Xv, Xv, Xv
Xv, Xv, Xv, Xv, Xv, Gll^Fdf, Gg, Rp, Rp, Rp, Rp, Rp, Rp, Rp, Hh, Ss, Rp, Rrc, Gg^Fet, Rrc, Rp, Ss, Hh, Rp, Rp, Rp, Rp, Rp, Rp, Rp, Gg, Gll^Fdf, Xv, Xv, Xv, Xv, Xv
Xv, Xv, Xv, Xv, Xv, Xv, Xv, Gll^Fdf, Gll^Fdf, Rp, Rp, Gll^Fdf, Rp, Rp, Rp, Ss^Bw/, Ss, Rrc, Rrc, Rrc, Ss, Ss^Bw\, Rp, Rp, Rp, Gll^Fdf, Rp, Rp, Gll^Fdf, Gll^Fdf, Xv, Xv, Xv, Xv, Xv, Xv, Xv
Xv, Xv, Xv, Xv, Xv, Xv, Xv, Xv, Xv, Hh, Hh, Rp, Rp, Rp, Rp, Rp, Rp, Rrc, Rrc, Rrc, Rp, Rp, Rp, Rp, Rp, Rp, Hh, Hh, Xv, Xv, Xv, Xv, Xv, Xv, Xv, Xv, Xv
Xv, Xv, Xv, Xv, Xv, Xv, Xv, Xv, Xv, Xv, Xv, Hh, Gll^Fdf, Rp, Rp, Rp, Ch, Rrc, Rrc, Rrc, Ch, Rp, Rp, Rp, Gll^Fdf, Hh, Xv, Xv, Xv, Xv, Xv, Xv, Xv, Xv, Xv, Xv, Xv
Xv, Xv, Xv, Xv, Xv, Xv, Xv, Xv, Xv, Xv, Xv, Xv, Xv, Gs^Vh, Gg, Ch, Ch, Ch, 6 Kh, Ch, Ch, Ch, Gg, Gs^Vh, Xv, Xv, Xv, Xv, Xv, Xv, Xv, Xv, Xv, Xv, Xv, Xv, Xv
Xv, Xv, Xv, Xv, Xv, Xv, Xv, Xv, Xv, Xv, Xv, Xv, Xv, Xv, Xv, Ch, Ch, Ch, Rrc, Ch, Ch, Ch, Xv, Xv, Xv, Xv, Xv, Xv, Xv, Xv, Xv, Xv, Xv, Xv, Xv, Xv, Xv
Xv, Xv, Xv, Xv, Xv, Xv, Xv, Xv, Xv, Xv, Xv, Xv, Xv, Xv, Xv, Xv, Xv, 3 Kh, Rra, 2 Kh, Xv, Xv, Xv, Xv, Xv, Xv, Xv, Xv, Xv, Xv, Xv, Xv, Xv, Xv, Xv, Xv, Xv
Xv, Xv, Xv, Xv, Xv, Xv, Xv, Xv, Xv, Xv, Xv, Xv, Xv, Xv, Xv, Xv, Xv, Xv, Xv, Xv, Xv, Xv, Xv, Xv, Xv, Xv, Xv, Xv, Xv, Xv, Xv, Xv, Xv, Xv, Xv, Xv, Xv
